serialNumber,transactionDate,pstdDate,transactionParticulars,chqNumber,valueDate,amount,drcr,balance,paymentMode,utrNumber,internalReferenceNumber,remittingBranch,remittingBankName,remittingAccountNumber,remittingAccountName,remittingIFSC,benficiaryBranch,benficiaryName,benficiaryAccountNumber,benficiaryIFSC,channel,timeStamp,remarks,transactionCurrencyCode,entryDate,referenceId,transactionIdentificationCode
1,27/02/2023,27/02/2023 13:50:55,NEFT/AXISP00135816257/TA/Jay, ,27/02/2023,1000,DR,1000,NEFT, ,AXISP00135816257,"SECTOR 49,GURGAON [HR]",AXIS BANK,918020068###404,ILACCEE STROL PSOCESPRRS TEIVAMI LITED,UTIB0001262, , , , ,NEFT,13:50:55,CMS/0000230580000003,INR,27/02/2023 13:50:54,AXISP00135816257,
2,27/02/2023,27/02/2023 13:50:55,NEFT/AXISP00135816257/TA/Jay, ,27/02/2023,1000,DR,2000,NEFT, ,AXISP00135816257,"SECTOR 49,GURGAON [HR]",AXIS BANK,918020068###404,ILACCEE STROL PSOCESPRRS TEIVAMI LITED,UTIB0001262, , , , ,NEFT,13:50:55,CMS/0000230580000003,INR,27/02/2023 13:50:54,AXISP00135816257,
3,27/02/2023,27/02/2023 14:49:56,NEFT/AXISP00135816258/0127022300601/Dinesh, ,27/02/2023,2000,DR,4000,NEFT, ,AXISP00135816258,"SECTOR 49,GURGAON [HR]",AXIS BANK,918020068###404,ILACCEE STROL PSOCESPRRS TEIVAMI LITED,UTIB0001262, , , , ,NEFT,14:49:56,CMS/0000230580000004,INR,27/02/2023 14:49:56,AXISP00135816258,
4,27/02/2023,27/02/2023 15:30:00,NEFT/AXISP00135816259/TA/John, ,27/02/2023,1500,DR,5500,NEFT, ,AXISP00135816259,"SECTOR 49,GURGAON [HR]",AXIS BANK,918020068###404,ILACCEE STROL PSOCESPRRS TEIVAMI LITED,UTIB0001262, , , , ,NEFT,15:30:00,CMS/0000230580000005,INR,27/02/2023 15:30:00,AXISP00135816259,
5,27/02/2023,27/02/2023 15:45:00,NEFT/AXISP00135816260/TA/Ravi, ,27/02/2023,2500,DR,8000,NEFT, ,AXISP00135816260,"SECTOR 49,GURGAON [HR]",AXIS BANK,918020068###404,ILACCEE STROL PSOCESPRRS TEIVAMI LITED,UTIB0001262, , , , ,NEFT,15:45:00,CMS/0000230580000006,INR,27/02/2023 15:45:00,AXISP00135816260,
6,27/02/2023,27/02/2023 16:00:00,NEFT/AXISP00135816261/TA/Meera, ,27/02/2023,3000,DR,11000,NEFT, ,AXISP00135816261,"SECTOR 49,GURGAON [HR]",AXIS BANK,918020068###404,ILACCEE STROL PSOCESPRRS TEIVAMI LITED,UTIB0001262, , , , ,NEFT,16:00:00,CMS/0000230580000007,INR,27/02/2023 16:00:00,AXISP00135816261,
